33
111111111111111111111111111111111
100000000000000000000000000000001
100000000000000000000000000000001
100000210000111111111000012000001
100000021000011111110000120000001
100000002100001111100001200000001
100200302100000111000001203002001
100120002100000010000001200021001
100012222100000000000001222210001
100001111100010000010001111100001
100000000000100000001000000000001
100000000001000000000100000000001
100100000010000000000010000001001
100110000100000222000001000011001
100111000000000000000000000111001
100111100000020000020000001111001
100111110000020040020000011111001
100111100000020000020000001111001
100111000000000000000000000111001
100110000100000222000001000011001
100100000010000000000010000001001
100000000001000000000100000000001
100000000000100000001000000000001
100001111100010000010001111100001
100012222100000000000001222210001
100120002100000010000001200021001
100200302100000111000001203002001
100000002100001111100001200000001
100000021000011111110000120000001
100000210000111111111000012000001
100000000000000000000000000000001
100000000000000000000000000000001
111111111111111111111111111111111